w w w w w w w w w w w w w
w . t . . . . . . . t . w
w t 0 . . . 1 . . . 2 . w
w . . . . . . . . . t . w
w . . . w . . . w w w w w
w . . . w . . . . . . . w
w . 6 t w . g . . . 8 t w
w . . . w . . . . . t . w
w . . . w . . . w w w w w
w . . . w . . . . . t . w
w t 2 . w . 3 . . . 4 t w
w . . . w . . . . . . . w
w w w w w w w w w w w w w
