$ $ $ $ $ $ $ $ $ $ $ $ $ $ $ $ $ $ $ $ $ $ $ $ $ $ $ $ $ $ $ $ $ $ $ $ $ $ $ $ $ $ $ $ $ $ $ $ $ $ $ $ $ $ $ $ $ $ $ $ $ $ $ $ $ $ $ $ $ $ $ $ $ $ $ $ $ $ $ $ $ $ $ $ $ $ $ $ $ $ $ $ $ $ $ $ $ $ $ $ $ $ $ $ $ $ $ $ $ $ $ $ $ $ $ $ $ $ $ $ $
$ . . . $ . . . . . . . . . . . . . . . . . . . . . . . . . . . $ . . . . . . . . . . . $ . . . . . . . . . . . $ . . . . . . . $ . . . . . . . $ . . . . . . . . . . . . . . . $ . . . . . . . . . . . . . . . $ . . . . . . . . . . . . . . . $
$ . 0 . $ . 1 . . . 2 . . . 3 . . . 4 . . . 5 . . . 6 . . . 7 . $ x 8 . . . 9 . . . 0 . $ . 1 . . . 2 . . . 3 . $ . 4 . . . 5 . $ . 6 . . . 7 . $ . 8 . . . 9 . . . 0 . . . 1 . $ . 2 . . . 3 . . . 4 . . . 5 . $ n 6 . . . 7 . . . 8 . . . 9 . $
$ . . . $ . . . . . . . . . . . . . . . . . . . . . . . . . . . $ . . . . . . . . . . . $ . . . . . . . . . . . $ . . . . . . . $ . . . . . . . $ . . . . . . . . . . . . . . . $ . . . . . . . . . . . . . . . $ . . . . . . . . . . . . . . . $
$ . . . $ . . . $ . . . $ $ $ $ $ $ $ $ $ $ $ $ $ . . . $ $ $ $ $ . . . $ $ $ $ $ . . . $ . . . $ $ $ $ $ . . . $ . . . $ . . . $ . . . $ . . . $ . . . $ $ $ $ $ . . . $ . . . $ $ $ $ $ . . . $ $ $ $ $ . . . $ . . . $ $ $ $ $ . . . $ . . . $
$ . . . . . . . $ . . . . . . . $ . . . . . . . . . . . $ . . . . . . . $ . . . . . . . $ . . . $ . . . . . . . $ . . . $ . . . . . . . $ . . . . . . . . . . . $ . . . $ . . . . . . . $ . . . . . . . $ . . . $ . . . $ . . . $ . . . $ . . . $
$ . 0 . . . 1 . $ . 2 . . . 3 . $ . 4 . . . 5 . . . 6 . $ x 7 . . . 8 x $ . X . . . 0 x $ . 1 . $ . 2 . . . 3 . $ . 4 . $ . 5 . . . 6 . $ . 7 . . . 8 . . . 9 . $ . 0 . $ . 1 . . . 2 . $ . 3 . . . 4 . $ . 5 . $ . 6 . $ . 7 . $ . 8 . $ n 9 n $
$ . . . . . . . $ . . . . . . . $ . . . . . . . . . . . $ . . . . . . . $ . . . . . . . $ . . . $ . . . . . . . $ . . . $ . . . . . . . $ . . . . . . . . . . . $ . . . $ . . . . . . . $ . . . . . . . $ . . . $ . . . $ . . . $ . . . $ . . . $
$ . . . $ $ $ $ $ $ $ $ $ . . . $ $ $ $ $ $ $ $ $ $ $ $ $ . . . $ $ $ $ $ . . . $ $ $ $ $ . . . $ . . . $ . . . $ . . . $ $ $ $ $ $ $ $ $ $ $ $ $ $ $ $ $ $ $ $ $ . . . $ $ $ $ $ . . . $ $ $ $ $ . . . $ $ $ $ $ . . . $ . . . $ . . . $ . . . $
$ . . . . . . . $ . . . $ . . . . . . . . . . . . . . . $ . . . $ . . . $ . . . . . . . . . . . $ . . . $ . . . $ . . . $ . . . . . . . . . . . $ . t . . . . . . . . . $ . . . $ . . . . . . . . . . . $ . . . . . . . $ . . . $ . . . $ . . . $
$ . 0 . . . 1 . $ . 2 . $ . 3 . . . 4 . . . 5 . . . 6 . $ . 7 . $ . 8 . $ . 9 . . . 0 . . . 1 . $ . 2 . $ . 3 . $ . 4 . $ . 5 . . . 6 . . . 7 . $ t 8 . . . 9 . . . 0 . $ . 1 . $ . 2 . . . 3 . . . 4 u $ . 5 . . . 6 . $ . 7 . $ . 8 . $ . N . $
$ . . . . . . . $ . . . $ . . . . . . . . . . . . . . . $ . . . $ . . . $ . x . . . . . . . x . $ . . . $ . . . $ . . . $ . . . . . . . . . . . $ . . . . . . . . . . . $ . . . $ . u . . . . . . . . . $ . . . . . . . $ . . . $ . . . $ . . . $
$ $ $ $ $ . . . $ . . . $ $ $ $ $ $ $ $ $ $ $ $ $ . . . $ . . . $ . . . $ $ $ $ $ $ $ $ $ $ $ $ $ . . . $ . . . $ . . . $ $ $ $ $ $ $ $ $ . . . $ . . . $ $ $ $ $ $ $ $ $ . . . $ $ $ $ $ $ $ $ $ . . . $ . . . $ $ $ $ $ . . . $ . . . $ $ $ $ $
$ . . . $ . . . . . . . $ . . . . . . . $ . . . $ . . . $ . . . $ . . . . . . . . . . . . . . . $ . . . $ . . . $ . . . . . . . . . . . $ . . . $ . . . . . . . $ . . . $ . . . . . . . $ . . . . . . . $ . . . $ . . . . . . . $ . . . . . n . $
$ . 0 . $ . 1 . . . 2 . $ . 3 . . . 4 . $ . 5 . $ . 6 . $ . 7 . $ . 8 . . . 9 . . . 0 . . . 1 . $ . 2 . $ . 3 . $ . 4 . . . 5 . . . 6 . $ . 7 . $ t 8 . . . T . $ . 0 . $ u 1 . . . U . $ u 3 . . . 4 . $ . 5 . $ . 6 . . . 7 . $ n 8 . . . 9 . $
$ . . . $ . . . . . . . $ . . . . . . . $ . . . $ . . . $ . . . $ . . . . . . . . . . . . . . . $ . . . $ . . . $ . . . . . . . . . . . $ . . . $ . . . . . . . $ . . . $ . . . . . . . $ . . . . . . . $ . . . $ . . . . . . . $ . . . . . . . $
$ . . . $ $ $ $ $ . . . $ . . . $ . . . $ . . . $ . . . $ . . . $ . . . $ $ $ $ $ . . . $ . . . $ . . . $ . . . $ $ $ $ $ $ $ $ $ . . . $ . . . $ $ $ $ $ . . . $ . . . $ . . . $ . . . $ . . . $ $ $ $ $ . . . $ . . . $ $ $ $ $ $ $ $ $ . . . $
$ . . . . . . . $ . . . . . . . $ . . . $ . . . $ . . . $ . . . $ . . . $ . . . . . . . $ . . . $ . . . $ . . . $ . . . . . . . . . . . $ . . . . . . . $ . . . $ . . . . . . . $ . . . . . . . . . . . $ . . . $ . . . . . . . . . . . $ . . . $
$ . 0 . . . 1 . $ . 2 . . . 3 . $ . 4 . $ . 5 . $ . 6 . $ . 7 . $ . 8 . $ . 9 . . . 0 . $ . 1 . $ . 2 . $ . 3 . $ . 4 . . . 5 . . . 6 . $ . 7 . . . 8 . $ t 9 . $ . 0 . . . 1 . $ . 2 . . . 3 . . . 4 . $ . 5 . $ . 6 . . . 7 . . . 8 . $ . 9 . $
$ . . . . . . . $ . . . . . . . $ . . . $ . . . $ . . . $ . . . $ . . . $ . . . . . . . $ . . . $ . . . $ . . . $ . . . . . . . . . . . $ . . . . . . . $ . . . $ . . . . . . . $ . u . . . . . . . . . $ . . . $ . . . . . . . . . . . $ . . . $
$ . . . $ $ $ $ $ $ $ $ $ $ $ $ $ . . . $ . . . $ . . . $ . . . $ . . . $ . . . $ $ $ $ $ . . . $ . . . $ $ $ $ $ . . . $ $ $ $ $ $ $ $ $ $ $ $ $ . . . $ . . . $ $ $ $ $ $ $ $ $ $ $ $ $ $ $ $ $ $ $ $ $ . . . $ $ $ $ $ . . . $ $ $ $ $ . . . $
$ . . . . . . . . . . . . . . . $ . . . . . . . $ . . . . . . . $ . . . $ . . . $ . . . $ . . . $ . . . $ . . . . . . . $ . . . . . . . . . . . $ . . . $ . . . . . . . . . . . . . . . . . . . . . . . $ . . . $ . . . . . . . $ . . . . . . . $
$ . 0 . . . 1 . . . 2 . . . 3 . $ . 4 . . . 5 . $ . 6 . . . 7 . $ . 8 . $ . 9 . $ . 0 . $ . 1 . $ . 2 . $ . 3 . . . 4 . $ . 5 . . . 6 . . . 7 . $ . 8 . $ t 9 . . . 0 . . . 1 . . . 2 . . . 3 . . . 4 . $ . 5 . $ . 6 . . . 7 . $ . 8 . . . 9 . $
$ . . . . . . . . . . . . . . . $ . . . . . . . $ . . . . . . . $ . . . $ . . . $ . . . $ . . . $ . . . $ . . . . . . . $ . . . . . . . . . . . $ . . . $ . . . . . . . . . . . . . . . . . . . . . . . $ . . . $ . . . . . . . $ . . . . . . . $
$ . . . $ $ $ $ $ $ $ $ $ . . . $ $ $ $ $ . . . $ $ $ $ $ $ $ $ $ . . . $ . . . $ . . . $ . . . $ . . . $ . . . $ $ $ $ $ $ $ $ $ . . . $ . . . $ . . . $ $ $ $ $ $ $ $ $ $ $ $ $ $ $ $ $ $ $ $ $ . . . $ . . . $ . . . $ . . . $ . . . $ . . . $
$ . . . . . . . $ . . . . . . . . . . . $ . . . . . y . $ . . . . . . . $ . . . $ . . . . . . . $ . . . $ . . . . . . . $ . . . . . . . $ . . . $ . . . . . . . . . . . . . . . . . . . . . . . $ . . . . . . . . . . . $ . . . $ . . . $ . . . $
$ . 0 . . . 1 . $ . 2 . . . 3 . . . 4 . $ . 5 . . . 6 y $ . 7 . . . 8 . $ . 9 . $ . 0 . . . 1 . $ . 2 . $ v 3 . . . 4 . $ . 5 . . . 6 . $ . 7 . $ . 8 . . . 9 . . . 0 . . . 1 . . . 2 . . . 3 . $ . 4 . . . 5 . . . 6 . $ . 7 . $ . 8 . $ . 9 . $
$ . . . . . . . $ . . . . . . . . . . . $ . . . . . . . $ . . . . . . . $ . . . $ . . . . . . . $ . . . $ . . . . . . . $ . . . . . . . $ . . . $ . . . . . . . . . . . . . . . . . . . . . . . $ . . . . . . . . . . . $ . . . $ . . . $ . . . $
$ $ $ $ $ $ $ $ $ . . . $ $ $ $ $ . . . $ $ $ $ $ . . . $ $ $ $ $ $ $ $ $ . . . $ $ $ $ $ $ $ $ $ . . . $ $ $ $ $ . . . $ . . . $ $ $ $ $ . . . $ . . . $ $ $ $ $ $ $ $ $ $ $ $ $ . . . $ $ $ $ $ $ $ $ $ $ $ $ $ $ $ $ $ . . . $ . . . $ . . . $
$ . . . . . . . $ . . . . . . . $ . . . . . . . $ . . . . . . . $ . . . . . . . $ . . . . . . . $ . . . $ . . . . . . . $ . . . $ . . . . . . . $ . . . . . . . . . . . $ . . . . . . . $ . . . . . . . $ . . . . . . . . . . . $ . . . $ . . . $
$ . 0 . . . 1 . $ . 2 . . . 3 . $ . 4 . . . 5 . $ . Y . . . 7 y $ . 8 . . . 9 . $ . 0 . . . 1 . $ . 2 . $ . 3 . . . V . $ . 5 . $ . 6 . . . 7 . $ . 8 . . . 9 . . . 0 . $ . 1 . . . 2 . $ . 3 . . . 4 . $ . 5 . . . 6 . . . 7 . $ . 8 . $ . 9 . $
$ . . . . . . . $ . . . . . . . $ . . . . . . . $ . . . . . . . $ . . . . . . . $ . . . . . . . $ . . . $ . . . . . . . $ . . . $ . . . . . . . $ . . . . . . . . . . . $ . . . . . . . $ . . . . . . . $ . . . . . . . . . . . $ . . . $ . . . $
$ . . . $ . . . $ $ $ $ $ . . . $ $ $ $ $ $ $ $ $ $ $ $ $ . . . $ . . . $ $ $ $ $ . . . $ . . . $ . . . $ . . . $ $ $ $ $ . . . $ $ $ $ $ . . . $ . . . $ $ $ $ $ . . . $ $ $ $ $ $ $ $ $ . . . $ . . . $ . . . $ $ $ $ $ $ $ $ $ . . . $ . . . $
$ . . . $ . . . . . . . . . . . $ . . . . . . . . . . . . . . . $ . . . . . . . $ . . . $ . . . $ . . . $ . . . . . v . $ . . . . . . . $ . . . $ . . . . . . . $ . . . $ . . . . . . . . . . . $ . . . $ . . . $ . . . . . . . . . . . $ . . . $
$ . 0 . $ . 1 . . . 2 . . . 3 . $ . 4 . . . 5 . . . 6 . . . 7 . $ . 8 . . . 9 . $ . 0 . $ . 1 w $ w 2 . $ v 3 . . . 4 v $ . 5 . . . 6 . $ . 7 . $ . 8 . . . 9 . $ . 0 . $ . 1 . . . 2 . . . 3 . $ . 4 . $ . 5 . $ . 6 . . . 7 . . . 8 . $ . 9 . $
$ . . . $ . . . . . . . . . . . $ . . . . . . . . . y . . . . . $ . . . . . . . $ . . . $ . . . $ . . . $ . . . . . . . $ . . . . . . . $ . . . $ . . . . . . . $ . . . $ . . . . . . . . . . . $ . . . $ . . . $ . . . . . . . . . . . $ . . . $
$ . . . $ $ $ $ $ . . . $ $ $ $ $ . . . $ $ $ $ $ $ $ $ $ $ $ $ $ $ $ $ $ . . . $ . . . $ . . . $ . . . $ $ $ $ $ . . . $ . . . $ . . . $ . . . $ $ $ $ $ $ $ $ $ . . . $ . . . $ $ $ $ $ $ $ $ $ . . . $ $ $ $ $ . . . $ $ $ $ $ $ $ $ $ . . . $
$ . . . $ . . . . . . . $ . . . . . . . $ . . . . . . . . . . . $ . . . . . . . $ . . . $ . . . $ . . . . . w . $ . . . $ . . . $ . . . $ . . . . . . . . . . . . . . . $ . . . $ . . . . . . . $ . . . $ . . . . . . . $ . . . . . . . $ . . . $
$ . 0 . $ . 1 . . . 2 . $ . 3 . . . 4 . $ . 5 . . . 6 . . . 7 . $ . 8 . . . 9 . $ . 0 w $ . 1 . $ . 2 . . . 3 . $ . 4 . $ . 5 . $ . 6 . $ . 7 . . . 8 . . . 9 . . . 0 . $ . 1 . $ . 2 . . . 3 . $ . 4 . $ . 5 . . . 6 . $ . 7 . . . 8 . $ . 9 . $
$ . . . $ . . . . . . . $ . . . . . . . $ . . . . . . . . . . . $ . . . . . . . $ . . . $ . . . $ . . . . . . . $ . . . $ . . . $ . . . $ . . . . . . . . . . . . . . . $ . . . $ . . . . . . . $ . . . $ . . . . . . . $ . . . . . . . $ . . . $
$ . . . $ $ $ $ $ $ $ $ $ . . . $ $ $ $ $ $ $ $ $ . . . $ . . . $ . . . $ $ $ $ $ . . . $ . . . $ . . . $ . . . $ . . . $ $ $ $ $ . . . $ . . . $ $ $ $ $ $ $ $ $ $ $ $ $ $ $ $ $ $ $ $ $ . . . $ . . . $ . . . $ $ $ $ $ . . . $ . . . $ $ $ $ $
$ . . . . . . . . . . . $ . . . $ . . . . . . . . . . . $ . . . $ . . . . . . . $ . . . $ . . . . . . . $ . . . $ . . . . . . . . . . . $ . . . $ . . . . . . . $ . . . . . s . . . . . . . . . $ . . . $ . . . $ . . . . . . . $ . . . . . . . $
$ . 0 . . . 1 . . . 2 . $ . 3 . $ . 4 . . . 5 . . . 6 . $ . 7 . $ . 8 . . . 9 . $ . 0 . $ . W . . . 2 w $ . 3 . $ . 4 . . . 5 . . . 6 . $ . 7 . $ . 8 . . . 9 s $ . S . . . 1 . . . 2 . . . 3 . $ . 4 . $ . 5 . $ . 6 . . . 7 . $ . 8 . . . 9 . $
$ . . . . . . . . . . . $ . . . $ . . . . . . . . . . . $ . . . $ . . . . . . . $ . . . $ . . . . . . . $ . . . $ . v . . . . . . . . . $ . . . $ . . . . . . . $ . . . . . s . . . . . . . . . $ . . . $ . . . $ . . . . . . . $ . . . . . . . $
$ . . . $ $ $ $ $ . . . $ . . . $ $ $ $ $ . . . $ $ $ $ $ . . . $ $ $ $ $ . . . $ . . . $ $ $ $ $ $ $ $ $ . . . $ $ $ $ $ $ $ $ $ $ $ $ $ . . . $ . . . $ . . . $ . . . $ $ $ $ $ . . . $ $ $ $ $ . . . $ . . . $ . . . $ $ $ $ $ $ $ $ $ . . . $
$ . . . $ . . . $ . . . $ . . . . . . . . . . . $ . . . $ . . . . . . . . . . . $ . . . . . . . $ . . . . . . . . . . . . . . . $ . . . . . . . $ . . . $ . . . . . . . $ . . . $ . . . . . . . . . . . $ . . . . . . . $ . . . . . . . . . . . $
$ . 0 . $ . 1 . $ . 2 . $ . 3 . . . 4 . . . 5 . $ . 6 . $ . 7 . . . 8 . . . 9 . $ . 0 . . . 1 . $ . 2 . . . 3 . . . 4 . . . 5 . $ . 6 . . . 7 . $ . 8 . $ s 9 . . . 0 s $ . 1 . $ . 2 . . . 3 . . . 4 . $ . 5 . . . 6 . $ . 7 . . . 8 . . . 9 . $
$ . . . $ . . . $ . . . $ . . . . . . . . . . . $ . . . $ . . . . . . . . . . . $ . . . . . . . $ . . . . . . . . . . . . . . . $ . . . . . . . $ . . . $ . . . . . . . $ . . . $ . . . . . . . . . . . $ . . . . . . . $ . . . . . . . . . . . $
$ . . . $ . . . $ . . . $ $ $ $ $ $ $ $ $ $ $ $ $ . . . $ . . . $ $ $ $ $ $ $ $ $ $ $ $ $ . . . $ $ $ $ $ $ $ $ $ $ $ $ $ $ $ $ $ . . . $ $ $ $ $ . . . $ $ $ $ $ $ $ $ $ . . . $ $ $ $ $ $ $ $ $ $ $ $ $ . . . $ $ $ $ $ . . . $ $ $ $ $ $ $ $ $
$ . . . $ . . . $ . . . . . . . . . . . . . . . . . . . $ . . . $ . q . . . . . . . . . $ . . . . . . . . . . . . . . . . . . . . . . . . . . . $ . . . . . . . $ . . . . . . . . . . . $ . m . $ . . . . . . . $ . . . $ . . . . . . . . . . . $
$ . 0 . $ . 1 . $ . 2 . . . 3 . . . 4 . . . 5 . . . 6 . $ . 7 . $ q 8 . . . 9 . . . 0 . $ . 1 . . . 2 . . . 3 . . . 4 . . . 5 . . . 6 . . . 7 . $ . 8 . . . 9 . $ . 0 . . . 1 . . . 2 . $ . 3 . $ m 4 . . . 5 . $ . M . $ m 7 . . . 8 . . . 9 . $
$ . . . $ . . . $ . . . . . . . . . . . . . . . . . . . $ . . . $ . . . . . . . . . . . $ . . . . . . . . . . . . . . . . . . . . . . . . . . . $ . . . . . . . $ . . . . . . . . . . . $ . . . $ . . . . . . . $ . . . $ . m . . . . . . . . . $
$ . . . $ . . . $ $ $ $ $ . . . $ $ $ $ $ . . . $ $ $ $ $ . . . $ . . . $ $ $ $ $ . . . $ $ $ $ $ . . . $ $ $ $ $ $ $ $ $ $ $ $ $ $ $ $ $ $ $ $ $ $ $ $ $ . . . $ . . . $ $ $ $ $ . . . $ . . . $ . . . $ $ $ $ $ . . . $ $ $ $ $ $ $ $ $ . . . $
$ . . . $ . . . . . . . $ . . . . . . . $ . . . $ . . . . . . . $ . . . $ . . . $ . . . . . . . $ . . . . . . . $ . . . . . r . . . . . . . . . . . . . . . . . $ . . . $ . . . $ . . . $ . . . $ . . . . . . . . . . . . . . . . . . . $ . . . $
$ . 0 . $ . 1 . . . 2 . $ . 3 . . . 4 . $ . 5 . $ . 6 . . . 7 . $ q 8 . $ . Q . $ . 0 . . . 1 . $ . 2 . . . 3 . $ . R . . . 5 . . . 6 . . . 7 . . . 8 . . . 9 . $ . 0 j $ . J . $ j 2 . $ . 3 . $ . 4 . . . 5 . . . 6 . . . 7 . . . 8 . $ . 9 . $
$ . . . $ . . . . . . . $ . . . . . . . $ . . . $ . . . . . . . $ . . . $ . . . $ . . . . . . . $ . . . . . . . $ . . . . . r . . . r . . . . . . . . . . . . . $ . . . $ . . . $ . . . $ . . . $ . m . . . . . . . . . . . . . . . . . $ . . . $
$ . . . $ $ $ $ $ . . . $ $ $ $ $ . . . $ . . . $ . . . $ $ $ $ $ . . . $ . . . $ $ $ $ $ . . . $ . . . $ $ $ $ $ . . . $ $ $ $ $ $ $ $ $ $ $ $ $ $ $ $ $ $ $ $ $ . . . $ . . . $ . . . $ . . . $ $ $ $ $ $ $ $ $ $ $ $ $ . . . $ $ $ $ $ . . . $
$ . . . . . . . $ . . . . . . . $ . . . $ . . . $ . . . . . . . $ . . . . . . . $ . . . . . . . $ . . . $ . r . . . . . $ . . . . . . . $ . . . . . . . . . . . . . . . $ . . . . . . . $ . . . . . . . . . . . . . . . . . . . $ . . . . . . . $
$ . 0 . . . 1 . $ . 2 . . . 3 . $ . 4 . $ . 5 . $ . 6 . . . 7 . $ . 8 . . . 9 q $ . 0 . . . 1 . $ . 2 . $ . 3 . . . 4 r $ . 5 . . . 6 . $ . 7 . . . 8 . . . 9 . . . 0 . $ . 1 . . . 2 . $ . 3 . . . 4 . . . 5 . . . 6 . . . 7 . $ . 8 . . . 9 . $
$ . . . . . . . $ . . . . . . . $ . . . $ . . . $ . . . . . . . $ . . . . . . . $ . . . . . . . $ . . . $ . . . . . . . $ . . . . . . . $ . . . . . . . . . . . . . . . $ . . . . . j . $ . . . . . . . . . . . . . . . . . . . $ . . . . . . . $
$ $ $ $ $ . . . $ . . . $ . . . $ . . . $ $ $ $ $ . . . $ $ $ $ $ $ $ $ $ . . . $ . . . $ $ $ $ $ . . . $ . . . $ $ $ $ $ . . . $ $ $ $ $ . . . $ $ $ $ $ . . . $ $ $ $ $ . . . $ $ $ $ $ $ $ $ $ $ $ $ $ $ $ $ $ $ $ $ $ $ $ $ $ . . . $ $ $ $ $
$ . . . $ . . . $ . . . $ . . . $ . . . . . . . $ . . . $ . . . . . . . . . . . $ . . . $ . . . $ . . . $ . . . $ . . . . . . . $ . . . . . . . $ . . . . . . . $ . . . . . . . . . . . $ . . . . . . . . . . . . . . . . . . . $ . . . . . . . $
$ . 0 . $ . 1 . $ . 2 . $ . 3 . $ . 4 . . . 5 . $ . 6 . $ . 7 . . . 8 . . . 9 q $ . 0 . $ . 1 . $ . 2 . $ . 3 . $ . A . . . 5 a $ . 6 . . . 7 a $ . 8 . . . 9 . $ j 0 . . . 1 . . . 2 . $ . 3 . . . 4 . . . 5 . . . 6 . . . 7 . $ . 8 . . . 9 . $
$ . . . $ . . . $ . . . $ . . . $ . . . . . . . $ . . . $ . . . . . . . . . . . $ . . . $ . . . $ . . . $ . . . $ . . . . . . . $ . . . . . . . $ . . . . . . . $ . . . . . j . . . . . $ . . . . . . . . . . . . . . . . . . . $ . . . . . . . $
$ . . . $ . . . $ $ $ $ $ . . . $ $ $ $ $ . . . $ . . . $ . . . $ $ $ $ $ $ $ $ $ . . . $ . . . $ . . . $ . . . $ . . . $ $ $ $ $ . . . $ $ $ $ $ . . . $ $ $ $ $ $ $ $ $ $ $ $ $ . . . $ . . . $ $ $ $ $ $ $ $ $ $ $ $ $ . . . $ $ $ $ $ . . . $
$ . . . $ . . . $ . . . . . . . $ . . . $ . . . . . . . $ . . . . . . . . . . . $ . . . $ . . . $ . . . $ . . . $ . . . . . . . . . . . . . . . $ . . . . . . . . . . . $ . . . $ . . . $ . . . . . . . . . . . $ . . . . . . . . . . . . . . . $
$ . 0 . $ . 1 . $ . 2 . . . 3 . $ . 4 . $ . 5 . . . 6 . $ . 7 . . . 8 . . . 9 . $ . 0 . $ . 1 . $ . 2 . $ . 3 . $ . 4 . . . 5 . . . 6 . . . 7 a $ . 8 . . . 9 . . . 0 . $ . 1 . $ . 2 . $ . 3 . . . 4 . . . 5 . $ . 6 . . . 7 . . . 8 . . . 9 . $
$ . . . $ . . . $ . . . . . . . $ . . . $ . . . . . . . $ . . . . . . . . . . . $ . . . $ . . . $ . . . $ . . . $ . . . . . a . . . . . . . . . $ . . . . . . . . . . . $ . . . $ . . . $ . . . . . . . . . . . $ . . . . . . . . . . . . . . . $
$ . . . $ . . . $ . . . $ . . . $ . . . $ $ $ $ $ $ $ $ $ $ $ $ $ . . . $ $ $ $ $ . . . $ . . . $ . . . $ . . . $ . . . $ $ $ $ $ $ $ $ $ $ $ $ $ . . . $ $ $ $ $ . . . $ . . . $ . . . $ . . . $ $ $ $ $ . . . $ $ $ $ $ $ $ $ $ $ $ $ $ . . . $
$ . . . $ . . . $ . . . $ . . . $ . . . . . . . $ . . . . . . . . . . . $ . . . . . . . $ . . . . . . . $ . . . $ . . . $ . a . $ . . . . . . . $ . . . . . . . $ . . . $ . . . . . . . $ . . . . . . . $ . . . . . . . $ . . . . . . . $ . . . $
$ . 0 . $ . 1 . $ . 2 . $ . 3 . $ . 4 . . . 5 . $ . 6 . . . 7 . . . 8 . $ . 9 . . . 0 . $ . 1 . . . 2 . $ . 3 . $ . 4 . $ . 5 . $ . 6 . . . 7 . $ . 8 . . . 9 . $ . 0 . $ . 1 . . . 2 . $ . 3 . . . 4 . $ . 5 . . . 6 . $ . 7 . . . 8 . $ . 9 . $
$ . . . $ . . . $ . . . $ . . . $ . . . . . . . $ . . . . . . . . . . . $ . . . . . . . $ . . . . . . . $ . . . $ . . . $ . . . $ . . . . . . . $ . . . . . . . $ . . . $ . . . . . . . $ . . . . . . . $ . . . . . . . $ . . . . . . . $ . . . $
$ . . . $ . . . $ . . . $ . . . $ . . . $ . . . $ . . . $ $ $ $ $ $ $ $ $ . . . $ $ $ $ $ $ $ $ $ $ $ $ $ . . . $ . . . $ . . . $ . . . $ . . . $ $ $ $ $ $ $ $ $ . . . $ . . . $ $ $ $ $ $ $ $ $ . . . $ $ $ $ $ . . . $ $ $ $ $ . . . $ . . . $
$ . . . . . . . $ . . . $ . . . $ . . . $ . . . $ . . . . . . . $ . . . $ . . . . . . . . . . . . . . . . . . . $ . . . . . . . $ . . . $ . . . . . . . $ . . . . . . . $ . . . . . . . $ . . . . . . . $ . . . $ . . . . . . . $ . . . . . . . $
$ . 0 . . . 1 . $ . 2 . $ . 3 . $ . 4 . $ . 5 . $ . 6 . . . 7 . $ . O . $ . 9 . . . 0 . . . 1 . . . 2 . . . 3 . $ . 4 . . . 5 . $ . 6 . $ . 7 . . . 8 . $ . 9 . . . 0 . $ . 1 . . . 2 . $ l 3 . . . 4 . $ . L . $ l 6 . . . 7 . $ . 8 . . . 9 . $
$ . . . . . . . $ . . . $ . . . $ . . . $ . . . $ . . . . . . . $ . . . $ . . . . . . . . . . . . . . . . . . . $ . . . . . . . $ . . . $ . f . . . . . $ . . . . . . . $ . b . . . . . $ . . . . . . . $ . . . $ . l . . . . . $ . . . . . . . $
$ . . . $ $ $ $ $ . . . $ . . . $ . . . $ . . . $ $ $ $ $ . . . $ . . . $ $ $ $ $ $ $ $ $ $ $ $ $ $ $ $ $ $ $ $ $ $ $ $ $ $ $ $ $ . . . $ $ $ $ $ . . . $ . . . $ $ $ $ $ $ $ $ $ . . . $ $ $ $ $ . . . $ . . . $ $ $ $ $ . . . $ $ $ $ $ $ $ $ $
$ . . . . . . . . . . . $ . . . . . . . $ . . . $ . . . . . . . $ . . . . . . . . . . . $ . . . . . . . . . . . . . . . . . . . . . . . $ . . . $ . . . $ . . . . . . . . . . . $ . . . . . . . $ . . . $ . . . . . . . $ . . . $ . . . . . . . $
$ . 0 . . . 1 . . . 2 . $ . 3 . . . 4 . $ . 5 . $ . 6 . . . 7 . $ . 8 . . . 9 . . . 0 o $ . 1 . . . 2 . . . 3 . . . 4 . . . 5 . . . 6 . $ . F . $ . 8 f $ . 9 . . . 0 . . . 1 . $ . 2 . . . 3 b $ . 4 . $ . 5 . . . 6 . $ . 7 . $ . 8 . . . 9 . $
$ . . . . . . . . . . . $ . . . . . . . $ . . . $ . . . . . . . $ . o . . . . . . . . . $ . . . . . . . . . . . . . . . . . . . . . . . $ . . . $ . . . $ . . . . . . . . . . . $ . . . . . . . $ . . . $ . . . . . . . $ . . . $ . . . . . . . $
$ $ $ $ $ $ $ $ $ . . . $ $ $ $ $ $ $ $ $ $ $ $ $ . . . $ $ $ $ $ $ $ $ $ . . . $ . . . $ . . . $ $ $ $ $ $ $ $ $ $ $ $ $ $ $ $ $ $ $ $ $ . . . $ . . . $ . . . $ $ $ $ $ . . . $ $ $ $ $ . . . $ . . . $ . . . $ . . . $ . . . $ . . . $ . . . $
$ . . . . . . . . . . . $ . p . . . . . $ . . . . . . . $ . . . . . . . . . . . $ . . . . . . . $ . . . . . . . $ . . . . . f . . . . . . . . . . . . . $ . . . . . . . $ . . . $ . . . $ . . . $ . . . . . . . $ . . . $ . . . . . . . $ . . . $
$ . 0 . . . 1 . . . 2 . $ . 3 . . . 4 . $ . 5 . . . 6 . $ o 7 . . . 8 . . . 9 . $ . 0 . . . 1 . $ . 2 . . . 3 . $ f 4 . . . 5 . . . 6 . . . 7 . . . 8 . $ . 9 . . . 0 . $ . 1 . $ . B . $ . 3 . $ . 4 . . . 5 . $ . 6 . $ . 7 . . . 8 . $ . 9 . $
$ . . . . . . . . . . . $ . . . . . . . $ . . . . . . . $ . o . . . . . . . . . $ . o . . . . . $ . . . . . . . $ . . . . . f . . . . . . . . . . . . . $ . . . . . . . $ . . . $ . . . $ . . . $ . . . . . l . $ . l . $ . . . . . . . $ . . . $
$ . . . $ $ $ $ $ $ $ $ $ . . . $ . . . $ . . . $ $ $ $ $ $ $ $ $ . . . $ $ $ $ $ $ $ $ $ $ $ $ $ . . . $ . . . $ . . . $ $ $ $ $ $ $ $ $ $ $ $ $ $ $ $ $ $ $ $ $ $ $ $ $ . . . $ . . . $ . . . $ $ $ $ $ $ $ $ $ $ $ $ $ $ $ $ $ $ $ $ $ . . . $
$ . . . . . . . . . . . $ . . . $ . . . . . . . $ . . . . . . . . . . . $ . . . . . e . $ . . . . . . . $ . . . . . . . $ . . . . . . . . . . . . . . . . . . . . . . . . . . . $ . . . $ . . . $ . . . . . . . . . . . . . . . . . . . . . . . $
$ . 0 . . . 1 . . . 2 . $ p 3 . $ . 4 . . . 5 . $ . 6 . . . 7 . . . 8 . $ . 9 . . . 0 e $ . 1 . . . 2 . $ . 3 . . . 4 . $ . 5 . . . 6 . . . 7 . . . 8 . . . 9 . . . 0 . . . 1 . $ . 2 . $ . 3 . $ . 4 . . . 5 . . . 6 . . . 7 . . . 8 . . . 9 . $
$ . . . . . . . . . . . $ . . . $ . . . . . . . $ . . . . . . . . . . . $ . . . . . . . $ . . . . . . . $ . . . . . . . $ . . . . . . . . . . . . . . . . . . . . . . . . . . . $ . . . $ . . . $ . . . . . . . . . . . . . . . . . . . . . . . $
$ $ $ $ $ . . . $ $ $ $ $ . . . $ $ $ $ $ $ $ $ $ . . . $ $ $ $ $ $ $ $ $ . . . $ $ $ $ $ . . . $ $ $ $ $ $ $ $ $ $ $ $ $ . . . $ . . . $ $ $ $ $ $ $ $ $ $ $ $ $ $ $ $ $ $ $ $ $ . . . $ . . . $ . . . $ . . . $ $ $ $ $ $ $ $ $ $ $ $ $ . . . $
$ . . . $ . . . $ . . . . . . . $ . . . . . . . . . . . $ . . . . . . . $ . . . . . . . $ . . . . . . . $ . . . . . . . . . . . $ . . . . . . . . . . . $ . . . . . . . $ . . . . . . . . . . . $ . . . $ . . . $ . . . . . . . $ . . . $ . . . $
$ . 0 . $ . 1 . $ . 2 . . . P . $ p 4 . . . 5 . . . 6 . $ e 7 . . . 8 . $ e 9 . . . E . $ . 1 . . . 2 . $ . 3 . . . 4 . . . 5 . $ . 6 . . . 7 . . . 8 . $ . 9 . . . 0 . $ b 1 . . . 2 . . . 3 . $ . 4 . $ . 5 . $ i 6 . . . 7 . $ . 8 . $ . 9 . $
$ . . . $ . . . $ . . . . . . . $ . . . . . . . . . . . $ . . . . . . . $ . . . . . . . $ . . . . . . . $ . . . . . . . . . . . $ . c . . . . . . . . . $ . . . . . . . $ . . . . . b . . . . . $ . . . $ . . . $ . . . . . . . $ . . . $ . . . $
$ . . . $ . . . $ . . . $ $ $ $ $ $ $ $ $ . . . $ $ $ $ $ . . . $ . . . $ $ $ $ $ . . . $ $ $ $ $ . . . $ . . . $ $ $ $ $ $ $ $ $ $ $ $ $ $ $ $ $ . . . $ . . . $ $ $ $ $ . . . $ $ $ $ $ $ $ $ $ . . . $ $ $ $ $ . . . $ . . . $ . . . $ . . . $
$ . . . $ . . . $ . . . $ . . . . . . . . . . . $ . . . . . . . $ . . . . . . . . . . . $ . . . . . . . $ . . . $ . . . . . . . . . . . . . . . $ . . . $ . . . . . . . $ . . . $ . . . . . . . . . . . $ . . . . . . . $ . . . $ . . . $ . . . $
$ . 0 . $ . 1 . $ . 2 . $ p 3 . . . 4 . . . 5 . $ . 6 . . . 7 . $ . 8 . . . 9 . . . 0 . $ . 1 . . . 2 . $ . 3 . $ c 4 . . . C . . . 6 . . . 7 . $ . 8 . $ . 9 . . . 0 . $ b 1 . $ i 2 . . . 3 . . . I . $ i 5 . . . 6 . $ . 7 . $ . 8 . $ . 9 . $
$ . . . $ . . . $ . . . $ . . . . . . . . . . . $ . . . . . . . $ . . . . . e . . . . . $ . . . . . . . $ . . . $ . . . . . . . . . . . . . . . $ . . . $ . . . . . . . $ . . . $ . . . . . . . . . . . $ . . . . . . . $ . . . $ . . . $ . . . $
$ . . . $ . . . $ . . . $ $ $ $ $ . . . $ $ $ $ $ . . . $ . . . $ $ $ $ $ $ $ $ $ $ $ $ $ . . . $ $ $ $ $ . . . $ . . . $ $ $ $ $ $ $ $ $ . . . $ . . . $ . . . $ . . . $ . . . $ $ $ $ $ . . . $ . . . $ . . . $ $ $ $ $ . . . $ . . . $ . . . $
$ . . . . . . . $ . . . . . . . . . . . $ . . . $ . . . $ . . . . . . . . . . . $ . . . . . . . $ . . . $ . . . $ . . . . . . . . . . . $ . . . . . . . $ . . . $ . . . $ . . . . . . . $ . . . $ . . . . . . . . . . . $ . . . $ . . . $ . . . $
$ . 0 . . . 1 . $ p 2 . . . 3 . . . 4 . $ . 5 . $ . 6 . $ . 7 . . . 8 . . . 9 . $ . 0 . . . 1 . $ . 2 . $ . 3 . $ . 4 . . . 5 . . . 6 . $ c 7 . . . 8 . $ . 9 . $ . 0 . $ . 1 . . . 2 . $ . 3 i $ . 4 . . . 5 . . . 6 . $ . 7 . $ . 8 . $ . 9 . $
$ . . . . . . . $ . . . . . . . . . . . $ . . . $ . . . $ . . . . . . . . . . . $ . . . . . . . $ . . . $ . . . $ . c . . . . . . . . . $ . . . . . . . $ . . . $ . . . $ . . . . . . . $ . i . $ . . . . . . . . . . . $ . . . $ . . . $ . . . $
$ . . . $ $ $ $ $ $ $ $ $ $ $ $ $ $ $ $ $ . . . $ . . . $ $ $ $ $ $ $ $ $ . . . $ . . . $ $ $ $ $ . . . $ . . . $ $ $ $ $ $ $ $ $ . . . $ $ $ $ $ $ $ $ $ . . . $ . . . $ $ $ $ $ . . . $ $ $ $ $ $ $ $ $ $ $ $ $ $ $ $ $ . . . $ . . . $ . . . $
$ . . . . . . . . . . . $ . . . . . . . . . . . $ . . . $ . . . $ . . . . . . . $ . . . $ . . . . . . . $ . . . . . . . $ . . . . . . . $ . . . . . . . $ . . . $ . . . . . . . . . . . $ . h . . . . . . . . . . . . . . . . . $ . . . . . . . $
$ . 0 . . . 1 . . . 2 . $ . 3 . . . 4 . . . 5 . $ . 6 . $ . 7 . $ . 8 . . . 9 . $ . 0 . $ . 1 . . . 2 . $ . 3 . . . 4 . $ . 5 . . . 6 . $ . 7 . . . 8 . $ . 9 . $ . 0 . . . 1 . . . 2 . $ . 3 . . . 4 . . . 5 . . . 6 . . . 7 . $ . 8 . . . 9 . $
$ . . . . . . . . . . . $ . . . . . . . . . . . $ . . . $ . . . $ . . . . . . . $ . . . $ . . . . . . . $ . . . . . . . $ . . . . . c . $ . . . . . . . $ . . . $ . . . . . . . . . . . $ . . . . . . . . . . . . . . . . . . . $ . k . . . . . $
$ $ $ $ $ $ $ $ $ . . . $ . . . $ $ $ $ $ . . . $ . . . $ . . . $ . . . $ $ $ $ $ . . . $ . . . $ $ $ $ $ $ $ $ $ . . . $ . . . $ $ $ $ $ . . . $ . . . $ . . . $ $ $ $ $ $ $ $ $ $ $ $ $ . . . $ $ $ $ $ $ $ $ $ $ $ $ $ $ $ $ $ $ $ $ $ . . . $
$ . . . . . . . $ . . . $ . . . . . . . $ . . . $ . . . . . . . $ . . . . . . . . . . . $ . . . . . . . . . . . . . . . $ . . . . . . . . . . . $ . . . $ . . . $ . . . . . . . . . . . $ . . . . . . . $ . . . . . . . . . . . . . . . $ . . . $
$ . 0 . . . 1 . $ . 2 . $ . 3 . . . 4 . $ . 5 . $ . 6 . . . 7 . $ . 8 . . . 9 . . . 0 . $ . 1 . . . 2 . . . 3 . . . 4 . $ . 5 . . . 6 . . . 7 . $ . 8 . $ . 9 g $ . 0 . . . 1 . . . 2 . $ h 3 . . . 4 . $ . 5 . . . 6 . . . 7 . . . 8 . $ . 9 k $
$ . . . . . . . $ . . . $ . . . . . . . $ . . . $ . . . . . . . $ . . . . . . . . . . . $ . . . . . . . . . . . . . . . $ . . . . . . . . . . . $ . . . $ . . . $ . . . . . . . . . . . $ . . . . . . . $ . . . . . . . . . . . . . . . $ . . . $
$ . . . $ . . . $ . . . $ . . . $ . . . $ . . . $ $ $ $ $ . . . $ $ $ $ $ $ $ $ $ $ $ $ $ $ $ $ $ $ $ $ $ $ $ $ $ . . . $ $ $ $ $ $ $ $ $ $ $ $ $ . . . $ . . . $ $ $ $ $ . . . $ . . . $ $ $ $ $ . . . $ . . . $ $ $ $ $ $ $ $ $ . . . $ . . . $
$ . . . $ . . . . . . . $ . . . $ . . . $ . . . . . . . $ . . . $ . . . . . . . . . . . . . . . . . . . . . . . $ . . . . . . . . . . . $ . . . . . . . $ . . . $ . g . . . . . $ . . . . . . . $ . . . . . . . . . . . $ . . . . . . . $ . . . $
$ . 0 . $ . 1 . . . 2 . $ . 3 . $ . 4 . $ . 5 . . . 6 . $ . 7 . $ d 8 . . . 9 . . . 0 . . . 1 . . . 2 . . . 3 d $ . 4 . . . 5 . . . 6 . $ . 7 . . . 8 . $ . 9 . $ . 0 . . . 1 . $ . 2 . . . 3 . $ h 4 . . . 5 . . . H . $ h 7 . . . 8 . $ . 9 . $
$ . . . $ . . . . . . . $ . . . $ . . . $ . . . . . . . $ . . . $ . . . . . . . . . . . . . d . . . . . . . . . $ . . . . . . . . . . . $ . . . . . . . $ . . . $ . . . . . . . $ . . . . . . . $ . . . . . . . . . . . $ . . . . . . . $ . . . $
$ . . . $ $ $ $ $ $ $ $ $ $ $ $ $ . . . $ $ $ $ $ . . . $ . . . $ $ $ $ $ . . . $ $ $ $ $ $ $ $ $ $ $ $ $ . . . $ $ $ $ $ . . . $ $ $ $ $ . . . $ $ $ $ $ . . . $ . . . $ $ $ $ $ $ $ $ $ . . . $ $ $ $ $ $ $ $ $ $ $ $ $ . . . $ $ $ $ $ . . . $
$ . . . . . . . $ . . . . . . . . . . . $ . . . . . . . $ . . . . . . . $ . . . $ . d . . . . . . . . . $ . . . $ . . . . . . . $ . . . . . . . $ . . . . . . . $ . . . $ . . . . . . . $ . . . $ . . . . . . . $ . h . . . . . $ . . . . . . . $
$ . 0 . . . 1 . $ . 2 . . . 3 . . . 4 . $ . 5 . . . 6 . $ . 7 . . . 8 . $ . 9 . $ . 0 . . . 1 . . . 2 . $ . 3 . $ . 4 . . . 5 . $ . 6 . . . 7 . $ . 8 . . . 9 . $ g 0 . $ . 1 . . . 2 . $ . 3 . $ . 4 . . . 5 . $ . 6 . . . 7 . $ k 8 . . . 9 k $
$ . . . . . . . $ . . . . . . . . . . . $ . . . . . . . $ . . . . . . . $ . . . $ . . . . . . . . . . . $ . . . $ . . . . . . . $ . . . . . . . $ . . . . . . . $ . . . $ . . . . . . . $ . . . $ . . . . . . . $ . . . . . . . $ . . . . . k . $
$ $ $ $ $ . . . $ . . . $ $ $ $ $ $ $ $ $ . . . $ $ $ $ $ $ $ $ $ . . . $ . . . $ . . . $ $ $ $ $ . . . $ . . . $ $ $ $ $ $ $ $ $ . . . $ $ $ $ $ . . . $ $ $ $ $ . . . $ . . . $ . . . $ . . . $ . . . $ . . . $ . . . $ $ $ $ $ . . . $ $ $ $ $
$ . . . . . . . . . . . $ . . . . . . . . . . . . . . . . . . . $ . . . . . . . $ . . . . . . . $ . . . . . . . . . . . . . . . . . . . $ . . . . . . . . . . . . . . . $ . . . $ . . . . . . . . . . . $ . . . . . . . $ . . . . . . . . . . . $
$ . 0 . . . 1 . . . 2 . $ . 3 . . . 4 . . . 5 . . . 6 . . . 7 . $ . 8 . . . 9 . $ . 0 . . . D . $ . 2 . . . 3 . . . 4 . . . 5 . . . 6 . $ . G . . . 8 . . . 9 . . . 0 g $ . 1 . $ . 2 . . . 3 . . . 4 . $ . 5 . . . 6 . $ . 7 . . . 8 . . . K . $
$ . . . . . . . . . . . $ . . . . . . . . . . . . . . . . . . . $ . . . . . . . $ . d . . . . . $ . . . . . . . . . . . . . . . . . . . $ . . . . . . . . . g . . . . . $ . . . $ . . . . . . . . . . . $ . . . . . . . $ . . . . . . . . . . . $
$ $ $ $ $ $ $ $ $ $ $ $ $ $ $ $ $ $ $ $ $ $ $ $ $ $ $ $ $ $ $ $ $ $ $ $ $ $ $ $ $ $ $ $ $ $ $ $ $ $ $ $ $ $ $ $ $ $ $ $ $ $ $ $ $ $ $ $ $ $ $ $ $ $ $ $ $ $ $ $ $ $ $ $ $ $ $ $ $ $ $ $ $ $ $ $ $ $ $ $ $ $ $ $ $ $ $ $ $ $ $ $ $ $ $ $ $ $ $ $ $
