w w w w w w w w w w w w w w w w w w w w w w w w w w w w w w w w w w w w w w w w w w w w w w w w w w w w w w w w w w w w w w w w w w w w w w w w w w w w w w w w w w w w w w w w w w w w w w w w w w w w w w w w w w w w w w w w w w w w w w w w w
w . . . w . . . . . . . . . . . . . . . . . . . . . . . . . . . w . . . . . . . . . . . w . . . . . . . . . . . w . . . . . . . w . . . . . . . w . . . . . . . . . . . . . . . w . . . . . . . . . . . . . . . w . . . . . . . . . . . . . . . w
w . 0 . w . 1 . . . 2 . . . 3 . . . 4 . . . 5 . . . 6 . . . 7 . w . 8 . . . 9 . . . 0 . w . 1 . . . 2 . . . 3 . w . 4 . . . 5 . w . 6 . . . 7 . w . 8 . . . 9 . . . 0 . . . 1 . w . 2 . . . 3 . . . 4 . . . 5 . w . 6 . . . 7 . . . 8 . . . 9 . w
w . . . w . . . . . . . . . . . . . . . . . . . . . . . . . . . w . . . . . . . . . . . w . . . . . . . . . . . w . . . . . . . w . . . . . . . w . . . . . . . . . . . . . . . w . . . . . . . . . . . . . . . w . . . . . . . . . . . . . . . w
w . . . w . . . w . . . w w w w w w w w w w w w w . . . w w w w w . . . w w w w w . . . w . . . w w w w w . . . w . . . w . . . w . . . w . . . w . . . w w w w w . . . w . . . w w w w w . . . w w w w w . . . w . . . w w w w w . . . w . . . w
w . . . . . . . w . . . . . . . w . . . . . . . . . . . w . . . . . . . w . . . . . . . w . . . w . . . . . . . w . . . w . . . . . . . w . . . . . . . . . . . w . . . w . . . . . . . w . . . . . . . w . . . w . . . w . . . w . . . w . . . w
w . 0 . . . 1 . w . 2 . . . 3 . w . 4 . . . 5 . . . 6 . w . 7 . . . 8 . w . 9 . . . 0 . w . 1 . w . 2 . . . 3 . w . 4 . w . 5 . . . 6 . w . 7 . . . 8 . . . 9 . w . 0 . w . 1 . . . 2 . w . 3 . . . 4 . w . 5 . w . 6 . w . 7 . w . 8 . w . 9 . w
w . . . . . . . w . . . . . . . w . . . . . . . . . . . w . . . . . . . w . . . . . . . w . . . w . . . . . . . w . . . w . . . . . . . w . . . . . . . . . . . w . . . w . . . . . . . w . . . . . . . w . . . w . . . w . . . w . . . w . . . w
w . . . w w w w w w w w w . . . w w w w w w w w w w w w w . . . w w w w w . . . w w w w w . . . w . . . w . . . w . . . w w w w w w w w w w w w w w w w w w w w w . . . w w w w w . . . w w w w w . . . w w w w w . . . w . . . w . . . w . . . w
w . . . . . . . w . . . w . . . . . . . . . . . . . . . w . . . w . . . w . . . . . . . . . . . w . . . w . . . w . . . w . . . . . . . . . . . w . . . . . . . . . . . w . . . w . . . . . . . . . . . w . . . . . . . w . . . w . . . w . . . w
w . 0 . . . 1 . w . 2 . w . 3 . . . 4 . . . 5 . . . 6 . w . 7 . w . 8 . w . 9 . . . 0 . . . 1 . w . 2 . w . 3 . w . 4 . w . 5 . . . 6 . . . 7 . w . 8 . . . 9 . . . 0 . w . 1 . w . 2 . . . 3 . . . 4 . w . 5 . . . 6 . w . 7 . w . 8 . w . 9 . w
w . . . . . . . w . . . w . . . . . . . . . . . . . . . w . . . w . . . w . . . . . . . . . . . w . . . w . . . w . . . w . . . . . . . . . . . w . . . . . . . . . . . w . . . w . . . . . . . . . . . w . . . . . . . w . . . w . . . w . . . w
w w w w w . . . w . . . w w w w w w w w w w w w w . . . w . . . w . . . w w w w w w w w w w w w w . . . w . . . w . . . w w w w w w w w w . . . w . . . w w w w w w w w w . . . w w w w w w w w w . . . w . . . w w w w w . . . w . . . w w w w w
w . . . w . . . . . . . w . . . . . . . w . . . w . . . w . . . w . . . . . . . . . . . . . . . w . . . w . . . w . . . . . . . . . . . w . . . w . . . . . . . w . . . w . . . . . . . w . . . . . . . w . . . w . . . . . . . w . . . . . . . w
w . 0 . w . 1 . . . 2 . w . 3 . . . 4 . w . 5 . w . 6 . w . 7 . w . 8 . . . 9 . . . 0 . . . 1 . w . 2 . w . 3 . w . 4 . . . 5 . . . 6 . w . 7 . w . 8 . . . 9 . w . 0 . w . 1 . . . 2 . w . 3 . . . 4 . w . 5 . w . 6 . . . 7 . w . 8 . . . 9 . w
w . . . w . . . . . . . w . . . . . . . w . . . w . . . w . . . w . . . . . . . . . . . . . . . w . . . w . . . w . . . . . . . . . . . w . . . w . . . . . . . w . . . w . . . . . . . w . . . . . . . w . . . w . . . . . . . w . . . . . . . w
w . . . w w w w w . . . w . . . w . . . w . . . w . . . w . . . w . . . w w w w w . . . w . . . w . . . w . . . w w w w w w w w w . . . w . . . w w w w w . . . w . . . w . . . w . . . w . . . w w w w w . . . w . . . w w w w w w w w w . . . w
w . . . . . . . w . . . . . . . w . . . w . . . w . . . w . . . w . . . w . . . . . . . w . . . w . . . w . . . w . . . . . . . . . . . w . . . . . . . w . . . w . . . . . . . w . . . . . . . . . . . w . . . w . . . . . . . . . . . w . . . w
w . 0 . . . 1 . w . 2 . . . 3 . w . 4 . w . 5 . w . 6 . w . 7 . w . 8 . w . 9 . . . 0 . w . 1 . w . 2 . w . 3 . w . 4 . . . 5 . . . 6 . w . 7 . . . 8 . w . 9 . w . 0 . . . 1 . w . 2 . . . 3 . . . 4 . w . 5 . w . 6 . . . 7 . . . 8 . w . 9 . w
w . . . . . . . w . . . . . . . w . . . w . . . w . . . w . . . w . . . w . . . . . . . w . . . w . . . w . . . w . . . . . . . . . . . w . . . . . . . w . . . w . . . . . . . w . . . . . . . . . . . w . . . w . . . . . . . . . . . w . . . w
w . . . w w w w w w w w w w w w w . . . w . . . w . . . w . . . w . . . w . . . w w w w w . . . w . . . w w w w w . . . w w w w w w w w w w w w w . . . w . . . w w w w w w w w w w w w w w w w w w w w w . . . w w w w w . . . w w w w w . . . w
w . . . . . . . . . . . . . . . w . . . . . . . w . . . . . . . w . . . w . . . w . . . w . . . w . . . w . . . . . . . w . . . . . . . . . . . w . . . w . . . . . . . . . . . . . . . . . . . . . . . w . . . w . . . . . . . w . . . . . . . w
w . 0 . . . 1 . . . 2 . . . 3 . w . 4 . . . 5 . w . 6 . . . 7 . w . 8 . w . 9 . w . 0 . w . 1 . w . 2 . w . 3 . . . 4 . w . 5 . . . 6 . . . 7 . w . 8 . w . 9 . . . 0 . . . 1 . . . 2 . . . 3 . . . 4 . w . 5 . w . 6 . . . 7 . w . 8 . . . 9 . w
w . . . . . . . . . . . . . . . w . . . . . . . w . . . . . . . w . . . w . . . w . . . w . . . w . . . w . . . . . . . w . . . . . . . . . . . w . . . w . . . . . . . . . . . . . . . . . . . . . . . w . . . w . . . . . . . w . . . . . . . w
w . . . w w w w w w w w w . . . w w w w w . . . w w w w w w w w w . . . w . . . w . . . w . . . w . . . w . . . w w w w w w w w w . . . w . . . w . . . w w w w w w w w w w w w w w w w w w w w w . . . w . . . w . . . w . . . w . . . w . . . w
w . . . . . . . w . . . . . . . . . . . w . . . . . . . w . . . . . . . w . . . w . . . . . . . w . . . w . . . . . . . w . . . . . . . w . . . w . . . . . . . . . . . . . . . . . . . . . . . w . . . . . . . . . . . w . . . w . . . w . . . w
w . 0 . . . 1 . w . 2 . . . 3 . . . 4 . w . 5 . . . 6 . w . 7 . . . 8 . w . 9 . w . 0 . . . 1 . w . 2 . w . 3 . . . 4 . w . 5 . . . 6 . w . 7 . w . 8 . . . 9 . . . 0 . . . 1 . . . 2 . . . 3 . w . 4 . . . 5 . . . 6 . w . 7 . w . 8 . w . 9 . w
w . . . . . . . w . . . . . . . . . . . w . . . . . . . w . . . . . . . w . . . w . . . . . . . w . . . w . . . . . . . w . . . . . . . w . . . w . . . . . . . . . . . . . . . . . . . . . . . w . . . . . . . . . . . w . . . w . . . w . . . w
w w w w w w w w w . . . w w w w w . . . w w w w w . . . w w w w w w w w w . . . w w w w w w w w w . . . w w w w w . . . w . . . w w w w w . . . w . . . w w w w w w w w w w w w w . . . w w w w w w w w w w w w w w w w w . . . w . . . w . . . w
w . . . . . . . w . . . . . . . w . . . . . . . w . . . . . . . w . . . . . . . w . . . . . . . w . . . w . . . . . . . w . . . w . . . . . . . w . . . . . . . . . . . w . . . . . . . w . . . . . . . w . . . . . . . . . . . w . . . w . . . w
w . 0 . . . 1 . w . 2 . . . 3 . w . 4 . . . 5 . w . 6 . . . 7 . w . 8 . . . 9 . w . 0 . . . 1 . w . 2 . w . 3 . . . 4 . w . 5 . w . 6 . . . 7 . w . 8 . . . 9 . . . 0 . w . 1 . . . 2 . w . 3 . . . 4 . w . 5 . . . 6 . . . 7 . w . 8 . w . 9 . w
w . . . . . . . w . . . . . . . w . . . . . . . w . . . . . . . w . . . . . . . w . . . . . . . w . . . w . . . . . . . w . . . w . . . . . . . w . . . . . . . . . . . w . . . . . . . w . . . . . . . w . . . . . . . . . . . w . . . w . . . w
w . . . w . . . w w w w w . . . w w w w w w w w w w w w w . . . w . . . w w w w w . . . w . . . w . . . w . . . w w w w w . . . w w w w w . . . w . . . w w w w w . . . w w w w w w w w w . . . w . . . w . . . w w w w w w w w w . . . w . . . w
w . . . w . . . . . . . . . . . w . . . . . . . . . . . . . . . w . . . . . . . w . . . w . . . w . . . w . . . . . . . w . . . . . . . w . . . w . . . . . . . w . . . w . . . . . . . . . . . w . . . w . . . w . . . . . . . . . . . w . . . w
w . 0 . w . 1 . . . 2 . . . 3 . w . 4 . . . 5 . . . 6 . . . 7 . w . 8 . . . 9 . w . 0 . w . 1 . w . 2 . w . 3 . . . 4 . w . 5 . . . 6 . w . 7 . w . 8 . . . 9 . w . 0 . w . 1 . . . 2 . . . 3 . w . 4 . w . 5 . w . 6 . . . 7 . . . 8 . w . 9 . w
w . . . w . . . . . . . . . . . w . . . . . . . . . . . . . . . w . . . . . . . w . . . w . . . w . . . w . . . . . . . w . . . . . . . w . . . w . . . . . . . w . . . w . . . . . . . . . . . w . . . w . . . w . . . . . . . . . . . w . . . w
w . . . w w w w w . . . w w w w w . . . w w w w w w w w w w w w w w w w w . . . w . . . w . . . w . . . w w w w w . . . w . . . w . . . w . . . w w w w w w w w w . . . w . . . w w w w w w w w w . . . w w w w w . . . w w w w w w w w w . . . w
w . . . w . . . . . . . w . . . . . . . w . . . . . . . . . . . w . . . . . . . w . . . w . . . w . . . . . . . w . . . w . . . w . . . w . . . . . . . . . . . . . . . w . . . w . . . . . . . w . . . w . . . . . . . w . . . . . . . w . . . w
w . 0 . w . 1 . . . 2 . w . 3 . . . 4 . w . 5 . . . 6 . . . 7 . w . 8 . . . 9 . w . 0 . w . 1 . w . 2 . . . 3 . w . 4 . w . 5 . w . 6 . w . 7 . . . 8 . . . 9 . . . 0 . w . 1 . w . 2 . . . 3 . w . 4 . w . 5 . . . 6 . w . 7 . . . 8 . w . 9 . w
w . . . w . . . . . . . w . . . . . . . w . . . . . . . . . . . w . . . . . . . w . . . w . . . w . . . . . . . w . . . w . . . w . . . w . . . . . . . . . . . . . . . w . . . w . . . . . . . w . . . w . . . . . . . w . . . . . . . w . . . w
w . . . w w w w w w w w w . . . w w w w w w w w w . . . w . . . w . . . w w w w w . . . w . . . w . . . w . . . w . . . w w w w w . . . w . . . w w w w w w w w w w w w w w w w w w w w w . . . w . . . w . . . w w w w w . . . w . . . w w w w w
w . . . . . . . . . . . w . . . w . . . . . . . . . . . w . . . w . . . . . . . w . . . w . . . . . . . w . . . w . . . . . . . . . . . w . . . w . . . . . . . w . . . . . . . . . . . . . . . w . . . w . . . w . . . . . . . w . . . . . . . w
w . 0 . . . 1 . . . 2 . w . 3 . w . 4 . . . 5 . . . 6 . w . 7 . w . 8 . . . 9 . w . 0 . w . 1 . . . 2 . w . 3 . w . 4 . . . 5 . . . 6 . w . 7 . w . 8 . . . 9 . w . 0 . . . 1 . . . 2 . . . 3 . w . 4 . w . 5 . w . 6 . . . 7 . w . 8 . . . 9 . w
w . . . . . . . . . . . w . . . w . . . . . . . . . . . w . . . w . . . . . . . w . . . w . . . . . . . w . . . w . . . . . . . . . . . w . . . w . . . . . . . w . . . . . . . . . . . . . . . w . . . w . . . w . . . . . . . w . . . . . . . w
w . . . w w w w w . . . w . . . w w w w w . . . w w w w w . . . w w w w w . . . w . . . w w w w w w w w w . . . w w w w w w w w w w w w w . . . w . . . w . . . w . . . w w w w w . . . w w w w w . . . w . . . w . . . w w w w w w w w w . . . w
w . . . w . . . w . . . w . . . . . . . . . . . w . . . w . . . . . . . . . . . w . . . . . . . w . . . . . . . . . . . . . . . w . . . . . . . w . . . w . . . . . . . w . . . w . . . . . . . . . . . w . . . . . . . w . . . . . . . . . . . w
w . 0 . w . 1 . w . 2 . w . 3 . . . 4 . . . 5 . w . 6 . w . 7 . . . 8 . . . 9 . w . 0 . . . 1 . w . 2 . . . 3 . . . 4 . . . 5 . w . 6 . . . 7 . w . 8 . w . 9 . . . 0 . w . 1 . w . 2 . . . 3 . . . 4 . w . 5 . . . 6 . w . 7 . . . 8 . . . 9 . w
w . . . w . . . w . . . w . . . . . . . . . . . w . . . w . . . . . . . . . . . w . . . . . . . w . . . . . . . . . . . . . . . w . . . . . . . w . . . w . . . . . . . w . . . w . . . . . . . . . . . w . . . . . . . w . . . . . . . . . . . w
w . . . w . . . w . . . w w w w w w w w w w w w w . . . w . . . w w w w w w w w w w w w w . . . w w w w w w w w w w w w w w w w w . . . w w w w w . . . w w w w w w w w w . . . w w w w w w w w w w w w w . . . w w w w w . . . w w w w w w w w w
w . . . w . . . w . . . . . . . . . . . . . . . . . . . w . . . w . . . . . . . . . . . w . . . . . . . . . . . . . . . . . . . . . . . . . . . w . . . . . . . w . . . . . . . . . . . w . . . w . . . . . . . w . . . w . . . . . . . . . . . w
w . 0 . w . 1 . w . 2 . . . 3 . . . 4 . . . 5 . . . 6 . w . 7 . w . 8 . . . 9 . . . 0 . w . 1 . . . 2 . . . 3 . . . 4 . . . 5 . . . 6 . . . 7 . w . 8 . . . 9 . w . 0 . . . 1 . . . 2 . w . 3 . w . 4 . . . 5 . w . 6 . w . 7 . . . 8 . . . 9 . w
w . . . w . . . w . . . . . . . . . . . . . . . . . . . w . . . w . . . . . . . . . . . w . . . . . . . . . . . . . . . . . . . . . . . . . . . w . . . . . . . w . . . . . . . . . . . w . . . w . . . . . . . w . . . w . . . . . . . . . . . w
w . . . w . . . w w w w w . . . w w w w w . . . w w w w w . . . w . . . w w w w w . . . w w w w w . . . w w w w w w w w w w w w w w w w w w w w w w w w w . . . w . . . w w w w w . . . w . . . w . . . w w w w w . . . w w w w w w w w w . . . w
w . . . w . . . . . . . w . . . . . . . w . . . w . . . . . . . w . . . w . . . w . . . . . . . w . . . . . . . w . . . . . . . . . . . . . . . . . . . . . . . w . . . w . . . w . . . w . . . w . . . . . . . . . . . . . . . . . . . w . . . w
w . 0 . w . 1 . . . 2 . w . 3 . . . 4 . w . 5 . w . 6 . . . 7 . w . 8 . w . 9 . w . 0 . . . 1 . w . 2 . . . 3 . w . 4 . . . 5 . . . 6 . . . 7 . . . 8 . . . 9 . w . 0 . w . 1 . w . 2 . w . 3 . w . 4 . . . 5 . . . 6 . . . 7 . . . 8 . w . 9 . w
w . . . w . . . . . . . w . . . . . . . w . . . w . . . . . . . w . . . w . . . w . . . . . . . w . . . . . . . w . . . . . . . . . . . . . . . . . . . . . . . w . . . w . . . w . . . w . . . w . . . . . . . . . . . . . . . . . . . w . . . w
w . . . w w w w w . . . w w w w w . . . w . . . w . . . w w w w w . . . w . . . w w w w w . . . w . . . w w w w w . . . w w w w w w w w w w w w w w w w w w w w w . . . w . . . w . . . w . . . w w w w w w w w w w w w w . . . w w w w w . . . w
w . . . . . . . w . . . . . . . w . . . w . . . w . . . . . . . w . . . . . . . w . . . . . . . w . . . w . . . . . . . w . . . . . . . w . . . . . . . . . . . . . . . w . . . . . . . w . . . . . . . . . . . . . . . . . . . w . . . . . . . w
w . 0 . . . 1 . w . 2 . . . 3 . w . 4 . w . 5 . w . 6 . . . 7 . w . 8 . . . 9 . w . 0 . . . 1 . w . 2 . w . 3 . . . 4 . w . 5 . . . 6 . w . 7 . . . 8 . . . 9 . . . 0 . w . 1 . . . 2 . w . 3 . . . 4 . . . 5 . . . 6 . . . 7 . w . 8 . . . 9 . w
w . . . . . . . w . . . . . . . w . . . w . . . w . . . . . . . w . . . . . . . w . . . . . . . w . . . w . . . . . . . w . . . . . . . w . . . . . . . . . . . . . . . w . . . . . . . w . . . . . . . . . . . . . . . . . . . w . . . . . . . w
w w w w w . . . w . . . w . . . w . . . w w w w w . . . w w w w w w w w w . . . w . . . w w w w w . . . w . . . w w w w w . . . w w w w w . . . w w w w w . . . w w w w w . . . w w w w w w w w w w w w w w w w w w w w w w w w w . . . w w w w w
w . . . w . . . w . . . w . . . w . . . . . . . w . . . w . . . . . . . . . . . w . . . w . . . w . . . w . . . w . . . . . . . w . . . . . . . w . . . . . . . w . . . . . . . . . . . w . . . . . . . . . . . . . . . . . . . w . . . . . . . w
w . 0 . w . 1 . w . 2 . w . 3 . w . 4 . . . 5 . w . 6 . w . 7 . . . 8 . . . 9 . w . 0 . w . 1 . w . 2 . w . 3 . w . A . . . 5 . w . 6 . . . 7 . w . 8 . . . 9 . w . 0 . . . 1 . . . 2 . w . 3 . . . 4 . . . 5 . . . 6 . . . 7 . w . 8 . . . 9 . w
w . . . w . . . w . . . w . . . w . . . . . . . w . . . w . . . . . . . . . . . w . . . w . . . w . . . w . . . w . . . . . . . w . . . . . . . w . . . . . . . w . . . . . . . . . . . w . . . . . . . . . . . . . . . . . . . w . . . . . . . w
w . . . w . . . w w w w w . . . w w w w w . . . w . . . w . . . w w w w w w w w w . . . w . . . w . . . w . . . w . . . w w w w w . . . w w w w w . . . w w w w w w w w w w w w w . . . w . . . w w w w w w w w w w w w w . . . w w w w w . . . w
w . . . w . . . w . . . . . . . w . . . w . . . . . . . w . . . . . . . . . . . w . . . w . . . w . . . w . . . w . . . . . . . . . . . . . . . w . . . . . . . . . . . w . . . w . . . w . . . . . . . . . . . w . . . . . . . . . . . . . . . w
w . 0 . w . 1 . w . 2 . . . 3 . w . 4 . w . 5 . . . 6 . w . 7 . . . 8 . . . 9 . w . 0 . w . 1 . w . 2 . w . 3 . w . 4 . . . 5 . . . 6 . . . 7 . w . 8 . . . 9 . . . 0 . w . 1 . w . 2 . w . 3 . . . 4 . . . 5 . w . 6 . . . 7 . . . 8 . . . 9 . w
w . . . w . . . w . . . . . . . w . . . w . . . . . . . w . . . . . . . . . . . w . . . w . . . w . . . w . . . w . . . . . . . . . . . . . . . w . . . . . . . . . . . w . . . w . . . w . . . . . . . . . . . w . . . . . . . . . . . . . . . w
w . . . w . . . w . . . w . . . w . . . w w w w w w w w w w w w w . . . w w w w w . . . w . . . w . . . w . . . w . . . w w w w w w w w w w w w w . . . w w w w w . . . w . . . w . . . w . . . w w w w w . . . w w w w w w w w w w w w w . . . w
w . . . w . . . w . . . w . . . w . . . . . . . w . . . . . . . . . . . w . . . . . . . w . . . . . . . w . . . w . . . w . a . w . . . . . . . w . . . . . . . w . . . w . . . . . . . w . . . . . . . w . . . . . . . w . . . . . . . w . . . w
w . 0 . w . 1 . w . 2 . w . 3 . w . 4 . . . 5 . w . 6 . . . 7 . . . 8 . w . 9 . . . 0 . w . 1 . . . 2 . w . 3 . w . 4 . w . 5 . w . 6 . . . 7 . w . 8 . . . 9 . w . 0 . w . 1 . . . 2 . w . 3 . . . 4 . w . 5 . . . 6 . w . 7 . . . 8 . w . 9 . w
w . . . w . . . w . . . w . . . w . . . . . . . w . . . . . . . . . . . w . . . . . . . w . . . . . . . w . . . w . . . w . . . w . . . . . . . w . . . . . . . w . . . w . . . . . . . w . . . . . . . w . . . . . . . w . . . . . . . w . . . w
w . . . w . . . w . . . w . . . w . . . w . . . w . . . w w w w w w w w w . . . w w w w w w w w w w w w w . . . w . . . w . . . w . . . w . . . w w w w w w w w w . . . w . . . w w w w w w w w w . . . w w w w w . . . w w w w w . . . w . . . w
w . . . . . . . w . . . w . . . w . . . w . . . w . . . . . . . w . . . w . . . . . . . . . . . . . . . . . . . w . . . . . . . w . . . w . . . . . . . w . . . . . . . w . . . . . . . w . . . . . . . w . . . w . . . . . . . w . . . . . . . w
w . 0 . . . 1 . w . 2 . w . 3 . w . 4 . w . 5 . w . 6 . . . 7 . w . 8 . w . 9 . . . 0 . . . 1 . . . 2 . . . 3 . w . 4 . . . 5 . w . 6 . w . 7 . . . 8 . w . 9 . . . 0 . w . 1 . . . 2 . w . 3 . . . 4 . w . 5 . w . 6 . . . 7 . w . 8 . . . 9 . w
w . . . . . . . w . . . w . . . w . . . w . . . w . . . . . . . w . . . w . . . . . . . . . . . . . . . . . . . w . . . . . . . w . . . w . . . . . . . w . . . . . . . w . . . . . . . w . . . . . . . w . . . w . . . . . . . w . . . . . . . w
w . . . w w w w w . . . w . . . w . . . w . . . w w w w w . . . w . . . w w w w w w w w w w w w w w w w w w w w w w w w w w w w w . . . w w w w w . . . w . . . w w w w w w w w w . . . w w w w w . . . w . . . w w w w w . . . w w w w w w w w w
w . . . . . . . . . . . w . . . . . . . w . . . w . . . . . . . w . . . . . . . . . . . w . . . . . . . . . . . . . . . . . . . . . . . w . . . w . . . w . . . . . . . . . . . w . . . . . . . w . . . w . . . . . . . w . . . w . . . . . . . w
w . 0 . . . 1 . . . 2 . w . 3 . . . 4 . w . 5 . w . 6 . . . 7 . w . 8 . . . 9 . . . 0 . w . 1 . . . 2 . . . 3 . . . 4 . . . 5 . . . 6 . w . 7 . w . 8 . w . 9 . . . 0 . . . 1 . w . 2 . . . 3 . w . 4 . w . 5 . . . 6 . w . 7 . w . 8 . . . 9 . w
w . . . . . . . . . . . w . . . . . . . w . . . w . . . . . . . w . . . . . . . . . . . w . . . . . . . . . . . . . . . . . . . . . . . w . . . w . . . w . . . . . . . . . . . w . . . . . . . w . . . w . . . . . . . w . . . w . . . . . . . w
w w w w w w w w w . . . w w w w w w w w w w w w w . . . w w w w w w w w w . . . w . . . w . . . w w w w w w w w w w w w w w w w w w w w w . . . w . . . w . . . w w w w w . . . w w w w w . . . w . . . w . . . w . . . w . . . w . . . w . . . w
w . . . . . . . . . . . w . . . . . . . w . . . . . . . w . . . . . . . . . . . w . . . . . . . w . . . . . . . w . . . . . . . . . . . . . . . . . . . w . . . . . . . w . . . w . . . w . . . w . . . . . . . w . . . w . . . . . . . w . . . w
w . 0 . . . 1 . . . 2 . w . 3 . . . 4 . w . 5 . . . 6 . w . 7 . . . 8 . . . 9 . w . 0 . . . 1 . w . 2 . . . 3 . w . 4 . . . 5 . . . 6 . . . 7 . . . 8 . w . 9 . . . 0 . w . 1 . w . 2 . w . 3 . w . 4 . . . 5 . w . 6 . w . 7 . . . 8 . w . 9 . w
w . . . . . . . . . . . w . . . . . . . w . . . . . . . w . . . . . . . . . . . w . . . . . . . w . . . . . . . w . . . . . . . . . . . . . . . . . . . w . . . . . . . w . . . w . . . w . . . w . . . . . . . w . . . w . . . . . . . w . . . w
w . . . w w w w w w w w w . . . w . . . w . . . w w w w w w w w w . . . w w w w w w w w w w w w w . . . w . . . w . . . w w w w w w w w w w w w w w w w w w w w w w w w w . . . w . . . w . . . w w w w w w w w w w w w w w w w w w w w w . . . w
w . . . . . . . . . . . w . . . w . . . . . . . w . . . . . . . . . . . w . . . . . . . w . . . . . . . w . . . . . . . w . . . . . . . . . . . . . . . . . . . . . . . . . . . w . . . w . . . w . . . . . . . . . . . . . . . . . . . . . . . w
w . 0 . . . 1 . . . 2 . w . 3 . w . 4 . . . 5 . w . 6 . . . 7 . . . 8 . w . 9 . . . 0 . w . 1 . . . 2 . w . 3 . . . 4 . w . 5 . . . 6 . . . 7 . . . 8 . . . 9 . . . 0 . . . 1 . w . 2 . w . 3 . w . 4 . . . 5 . . . 6 . . . 7 . . . 8 . . . 9 . w
w . . . . . . . . . . . w . . . w . . . . . . . w . . . . . . . . . . . w . . . . . . . w . . . . . . . w . . . . . . . w . . . . . . . . . . . . . . . . . . . . . . . . . . . w . . . w . . . w . . . . . . . . . . . . . . . . . . . . . . . w
w w w w w . . . w w w w w . . . w w w w w w w w w . . . w w w w w w w w w . . . w w w w w . . . w w w w w w w w w w w w w . . . w . . . w w w w w w w w w w w w w w w w w w w w w . . . w . . . w . . . w . . . w w w w w w w w w w w w w . . . w
w . . . w . . . w . . . . . . . w . . . . . . . . . . . w . . . . . . . w . . . . . . . w . . . . . . . w . . . . . . . . . . . w . . . . . . . . . . . w . . . . . . . w . . . . . . . . . . . w . . . w . . . w . . . . . . . w . . . w . . . w
w . 0 . w . 1 . w . 2 . . . 3 . w . 4 . . . 5 . . . 6 . w . 7 . . . 8 . w . 9 . . . 0 . w . 1 . . . 2 . w . 3 . . . 4 . . . 5 . w . 6 . . . 7 . . . 8 . w . 9 . . . 0 . w . 1 . . . 2 . . . 3 . w . 4 . w . 5 . w . 6 . . . 7 . w . 8 . w . 9 . w
w . . . w . . . w . . . . . . . w . . . . . . . . . . . w . . . . . . . w . . . . . . . w . . . . . . . w . . . . . . . . . . . w . . . . . . . . . . . w . . . . . . . w . . . . . . . . . . . w . . . w . . . w . . . . . . . w . . . w . . . w
w . . . w . . . w . . . w w w w w w w w w . . . w w w w w . . . w . . . w w w w w . . . w w w w w . . . w . . . w w w w w w w w w w w w w w w w w . . . w . . . w w w w w . . . w w w w w w w w w . . . w w w w w . . . w . . . w . . . w . . . w
w . . . w . . . w . . . w . . . . . . . . . . . w . . . . . . . w . . . . . . . . . . . w . . . . . . . w . . . w . . . . . . . . . . . . . . . w . . . w . . . . . . . w . . . w . . . . . . . . . . . w . . . . . . . w . . . w . . . w . . . w
w . 0 . w . 1 . w . 2 . w . 3 . . . 4 . . . 5 . w . 6 . . . 7 . w . 8 . . . 9 . . . 0 . w . 1 . . . 2 . w . 3 . w . 4 . . . 5 . . . 6 . . . 7 . w . 8 . w . 9 . . . 0 . w . 1 . w . 2 . . . 3 . . . 4 . w . 5 . . . 6 . w . 7 . w . 8 . w . 9 . w
w . . . w . . . w . . . w . . . . . . . . . . . w . . . . . . . w . . . . . . . . . . . w . . . . . . . w . . . w . . . . . . . . . . . . . . . w . . . w . . . . . . . w . . . w . . . . . . . . . . . w . . . . . . . w . . . w . . . w . . . w
w . . . w . . . w . . . w w w w w . . . w w w w w . . . w . . . w w w w w w w w w w w w w . . . w w w w w . . . w . . . w w w w w w w w w . . . w . . . w . . . w . . . w . . . w w w w w . . . w . . . w . . . w w w w w . . . w . . . w . . . w
w . . . . . . . w . . . . . . . . . . . w . . . w . . . w . . . . . . . . . . . w . . . . . . . w . . . w . . . w . . . . . . . . . . . w . . . . . . . w . . . w . . . w . . . . . . . w . . . w . . . . . . . . . . . w . . . w . . . w . . . w
w . 0 . . . 1 . w . 2 . . . 3 . . . 4 . w . 5 . w . 6 . w . 7 . . . 8 . . . 9 . w . 0 . . . 1 . w . 2 . w . 3 . w . 4 . . . 5 . . . 6 . w . 7 . . . 8 . w . 9 . w . 0 . w . 1 . . . 2 . w . 3 . w . 4 . . . 5 . . . 6 . w . 7 . w . 8 . w . 9 . w
w . . . . . . . w . . . . . . . . . . . w . . . w . . . w . . . . . . . . . . . w . . . . . . . w . . . w . . . w . . . . . . . . . . . w . . . . . . . w . . . w . . . w . . . . . . . w . . . w . . . . . . . . . . . w . . . w . . . w . . . w
w . . . w w w w w w w w w w w w w w w w w . . . w . . . w w w w w w w w w . . . w . . . w w w w w . . . w . . . w w w w w w w w w . . . w w w w w w w w w . . . w . . . w w w w w . . . w w w w w w w w w w w w w w w w w . . . w . . . w . . . w
w . . . . . . . . . . . w . . . . . . . . . . . w . . . w . . . w . . . . . . . w . . . w . . . . . . . w . . . . . . . w . . . . . . . w . . . . . . . w . . . w . . . . . . . . . . . w . . . . . . . . . . . . . . . . . . . w . . . . . . . w
w . 0 . . . 1 . . . 2 . w . 3 . . . 4 . . . 5 . w . 6 . w . 7 . w . 8 . . . 9 . w . 0 . w . 1 . . . 2 . w . 3 . . . 4 . w . 5 . . . 6 . w . 7 . . . 8 . w . 9 . w . 0 . . . 1 . . . 2 . w . 3 . . . 4 . . . 5 . . . 6 . . . 7 . w . 8 . . . 9 . w
w . . . . . . . . . . . w . . . . . . . . . . . w . . . w . . . w . . . . . . . w . . . w . . . . . . . w . . . . . . . w . . . . . . . w . . . . . . . w . . . w . . . . . . . . . . . w . . . . . . . . . . . . . . . . . . . w . . . . . . . w
w w w w w w w w w . . . w . . . w w w w w . . . w . . . w . . . w . . . w w w w w . . . w . . . w w w w w w w w w . . . w . . . w w w w w . . . w . . . w . . . w w w w w w w w w w w w w . . . w w w w w w w w w w w w w w w w w w w w w . . . w
w . . . . . . . w . . . w . . . . . . . w . . . w . . . . . . . w . . . . . . . . . . . w . . . . . . . . . . . . . . . w . . . . . . . . . . . w . . . w . . . w . . . . . . . . . . . w . . . . . . . w . . . . . . . . . . . . . . . w . . . w
w . 0 . . . 1 . w . 2 . w . 3 . . . 4 . w . 5 . w . 6 . . . 7 . w . 8 . . . 9 . . . 0 . w . 1 . . . 2 . . . 3 . . . 4 . w . 5 . . . 6 . . . 7 . w . 8 . w . 9 . w . 0 . . . 1 . . . 2 . w . 3 . . . 4 . w . 5 . . . 6 . . . 7 . . . 8 . w . 9 . w
w . . . . . . . w . . . w . . . . . . . w . . . w . . . . . . . w . . . . . . . . . . . w . . . . . . . . . . . . . . . w . . . . . . . . . . . w . . . w . . . w . . . . . . . . . . . w . . . . . . . w . . . . . . . . . . . . . . . w . . . w
w . . . w . . . w . . . w . . . w . . . w . . . w w w w w . . . w w w w w w w w w w w w w w w w w w w w w w w w w . . . w w w w w w w w w w w w w . . . w . . . w w w w w . . . w . . . w w w w w . . . w . . . w w w w w w w w w . . . w . . . w
w . . . w . . . . . . . w . . . w . . . w . . . . . . . w . . . w . . . . . . . . . . . . . . . . . . . . . . . w . . . . . . . . . . . w . . . . . . . w . . . w . . . . . . . w . . . . . . . w . . . . . . . . . . . w . . . . . . . w . . . w
w . 0 . w . 1 . . . 2 . w . 3 . w . 4 . w . 5 . . . 6 . w . 7 . w . 8 . . . 9 . . . 0 . . . 1 . . . 2 . . . 3 . w . 4 . . . 5 . . . 6 . w . 7 . . . 8 . w . 9 . w . 0 . . . 1 . w . 2 . . . 3 . w . 4 . . . 5 . . . 6 . w . 7 . . . 8 . w . 9 . w
w . . . w . . . . . . . w . . . w . . . w . . . . . . . w . . . w . . . . . . . . . . . . . . . . . . . . . . . w . . . . . . . . . . . w . . . . . . . w . . . w . . . . . . . w . . . . . . . w . . . . . . . . . . . w . . . . . . . w . . . w
w . . . w w w w w w w w w w w w w . . . w w w w w . . . w . . . w w w w w . . . w w w w w w w w w w w w w . . . w w w w w . . . w w w w w . . . w w w w w . . . w . . . w w w w w w w w w . . . w w w w w w w w w w w w w . . . w w w w w . . . w
w . . . . . . . w . . . . . . . . . . . w . . . . . . . w . . . . . . . w . . . w . . . . . . . . . . . w . . . w . . . . . . . w . . . . . . . w . . . . . . . w . . . w . . . . . . . w . . . w . . . . . . . w . . . . . . . w . . . . . . . w
w . 0 . . . 1 . w . 2 . . . 3 . . . 4 . w . 5 . . . 6 . w . 7 . . . 8 . w . 9 . w . 0 . . . 1 . . . 2 . w . 3 . w . 4 . . . 5 . w . 6 . . . 7 . w . 8 . . . 9 . w . 0 . w . 1 . . . 2 . w . 3 . w . 4 . . . 5 . w . 6 . . . 7 . w . 8 . . . 9 . w
w . . . . . . . w . . . . . . . . . . . w . . . . . . . w . . . . . . . w . . . w . . . . . . . . . . . w . . . w . . . . . . . w . . . . . . . w . . . . . . . w . . . w . . . . . . . w . . . w . . . . . . . w . . . . . . . w . . . . . . . w
w w w w w . . . w . . . w w w w w w w w w . . . w w w w w w w w w . . . w . . . w . . . w w w w w . . . w . . . w w w w w w w w w . . . w w w w w . . . w w w w w . . . w . . . w . . . w . . . w . . . w . . . w . . . w w w w w . . . w w w w w
w . . . . . . . . . . . w . . . . . . . . . . . . . . . . . . . w . . . . . . . w . . . . . . . w . . . . . . . . . . . . . . . . . . . w . . . . . . . . . . . . . . . w . . . w . . . . . . . . . . . w . . . . . . . w . . . . . . . . . . . w
w . 0 . . . 1 . . . 2 . w . 3 . . . 4 . . . 5 . . . 6 . . . 7 . w . 8 . . . 9 . w . 0 . . . 1 . w . 2 . . . 3 . . . 4 . . . 5 . . . 6 . w . 7 . . . 8 . . . 9 . . . 0 . w . 1 . w . 2 . . . 3 . . . 4 . w . 5 . . . 6 . w . 7 . . . 8 . . . 9 . w
w . . . . . . . . . . . w . . . . . . . . . . . . . . . . . . . w . . . . . . . w . . . . . . . w . . . . . . . . . . . . . . . . . . . w . . . . . . . . . . . . . . . w . . . w . . . . . . . . . . . w . . . . . . . w . . . . . . . . . . . w
w w w w w w w w w w w w w w w w w w w w w w w w w w w w w w w w w w w w w w w w w w w w w w w w w w w w w w w w w w w w w w w w w w w w w w w w w w w w w w w w w w w w w w w w w w w w w w w w w w w w w w w w w w w w w w w w w w w w w w w w w
